001110001111101
100010100000000
101110111101111
100000000000011
110111101011101
100001101000001
101110001011100
101000101010111
0011101110101G1
100010101010101
101100101110000
100010100100111
111011110100001
100000000001011
111111111111111